#################
#p    b s** *   #
# #  #*#*# #*#* #
#      *e****  *#
# # #*### #*# # #
#f      b  x ** #
# # # # # # # # #
#*  *   s  *  * #
# # # # #*# # # #
#*    **  *e    #
# #*# # # # # # #
#           *e  #
#################